2 11 13
#############
#p      ** *#
# # #*#*#*# #
#   * 2 * * #
# # # # # #*#
# *   1     #
# # #*# # # #
#  *        #
# # # # # # #
#           #
#############